################################################################
################################################################
##------------------------------------------------------------##
##------------------------------------------------------------##
##------------------------------------------------------------##
##------------------------------------------------------------##
##------------------------------------------------------------##
##------------------------------------------------------------##
##------------------------------------------------------------##
##------------------------------------------------------------##
##------------------------------------------------------------##
##------------------------------------------------------------##
##------------------------------------------------------------##
##------------------------------------------------------------##
##------------------------------------------------------------##
##------------------------------------------------------------##
##------------------------------###--------#######------------##
##------------------------------------------------------------##
##------------------------------------------------------------##
##------------------------------------------------------------##
##---------------------------------#####----------------------##
##----------------------------##------------------------------##
##-----------------------------------------GGGG---------------##
##------------------------------------------------------------##
##---------------------##-------------------------------------##
##------------------------------------------------------------##
##---------------------------------#P#------------------------##
##------------------------------------------------------------##
##---------------------------##-------------------------------##
##---------------------------##-------------------------------##
##---------------------------##-------------------------------##
##---------------------------##-------------------------------##
##---------------------------##-------------------------------##
##---------------------------##-------------------------------##
################################################################
################################################################
