################################################################
################################################################
##------------------------------------------------------------##
##------------------------------------------------------------##
##------------------------------------------------------------##
##------------------------------------------------------------##
##------------------------------------------------------------##
##------------------------------------------------------------##
##------------GGG---------------------------------------------##
##------------------------------------------------------------##
##------------------------------------------------------------##
##------------------------------------------------------------##
##--------------------#---------------------------------------##
##-------------------##---------------------------------------##
##------------------------------------------------------------##
##------------------------------------------------------------##
##------------------------------------------------------------##
##-----------------##-----------------------------------------##
##------------------##----------------------------------------##
##------------------------------------------------------------##
##------------------------------------------------------------##
##------------------------#-----------------------------------##
##-----------------------##-----------------------------------##
##------------------------------------------------------------##
##------------------------------------------------------------##
##------------------------------------------------------------##
##---------------------###----#-------------------------------##
##-----------------------#--#---------------------------------##
##-----------------------#--#---------------------------------##
##-----------------------####---------------------------------##
##----------------#P#-----------------------------------------##
##------------------------------------------------------------##
##------------------------------------------------------------##
##------------------------------------------------------------##
################################################################
################################################################
