################################################################
################################################################
##------------------------------------------------------------##
##------------------------------------------------------------##
##------------------------------------------------------------##
##------------------------------------------------------------##
##------------------------------------------------------------##
##------------------------------------------------------------##
##------------------------------------------------------------##
##------------------------------------------------------------##
##------------------------------------------------------------##
##----------------------------######--------------------------##
##------------------------------------------------------------##
##---------------------###------------------------------------##
##------------------------------------------------------------##
##------------------------------------------------------------##
##----------------###-----------------------------------------##
##------------------#-----------------------------------------##
##------------------#-----------------------------------------##
##-------------##---#-----------------------------------------##
##------------------#-----------------------------------------##
##------------------#-----------------------------------------##
##----------------###-----------------GGG---------------------##
##------------------------------------------------------------##
##------------------------------------------------------------##
##------------------------------------------------------------##
##------------------------------------------------------------##
##-----------------------------------#------------------------##
##------------------------------------------------------------##
##------------------------------------------------------------##
##------------------------------------------------------------##
##------------------------------------------------------------##
##------------------------------------------------------------##
##------------------------------------------------------------##
################################################################
################################################################
