################################################################
################################################################
##------------------------------------------------------------##
##------------------------------------------------------------##
##------------------------------------------------------------##
##------------------------------------------------------------##
##------------------------------------------------------------##
##------------------------------------------------------------##
##------------------------------------------------------------##
##------------------------------------------------------------##
##------------------------------------------------------------##
##------------------------------------------------------------##
##------------------------------------------------------------##
##------------------------------------------------------------##
##------------------------------------------------------------##
##------------------------------------------------------------##
##-------------------------------------------#####------------##
##------------------------------------------------------------##
##------------------------------------------------------------##
##-------------------------###--------------------------------##
##----------------------------------#####---------------------##
##------------------------------------#-----------------------##
##--------------###-------------------#-----GGGG--------------##
##-----------------------------###----#-----------------------##
##------------------------------------#-----------------------##
##------------------------------------#-----------------------##
##------------------#####-----------P##-----------------------##
##---------------------------###-----------###----------------##
##------------------------------------------------------------##
##------------------------------------------------------------##
##---------------------------------######---------------------##
##------------------------------------------------------------##
##------------------------------------------------------------##
##------------------------------------------------------------##
################################################################
################################################################
