################################################################
################################################################
##------------------------------------------------------------##
##------------------------------------------------------------##
##------------------------------------------------------------##
##------------------------------------------------------------##
##------------------------------------------------------------##
##------------------------------------------------------------##
##------------------------------------------------------------##
##------------------------------------------------------------##
##-----######--#----#--######--######--#####------------------##
##-----#-------#----#--#----#--#----#--#----------------------##
##-----#-------#----#--#----#--#----#--#----------------------##
##-----#-------#----#--#----#--#----#--#----------------------##
##-----######--######--######--#----#--#####------------------##
##----------#--#----#--#----#--#----#--#----------------------##
##----------#--#----#--#----#--#----#--#----------------------##
##----------#--#----#--#----#--#----#--#----------------------##
##----------#--#----#--#----#--######--#----------------------##
##-----######--#----#--#----#--#-------#GGGG------------------##
##------------------------------------------------------------##
##------------------------------------------------------------##
##--------------------#####--#---#--#####--#####--####--####--##
##--------------------#------#---#--#---#--#---#--#-----#--#--##
##--------------------#------#---#--#---#--#---#--#-----#--#--##
##--------------------#------#---#--#---#--#####--#-----#--#--##
##--------------------#####--#####--#####--#------####--#####-##
##------------------------#--#---#--#---#--#------#-----#---#-##
##------------------------#--#---#--#---#--#------#-----#---#-##
##------------------------#--#---#--#---#--#------#-----#---#-##
##--------------------GGGG#--#---#--#---#--#------####--#---#-##
##------------------------------------------------------------##
##------------------------------------------------------------##
##------------------------------------------------------------##
#######P##################################################GGGG##
################################################################
