################################################################
################################################################
##------------------------------------------------------------##
##------------------------------------------------------------##
##------------------------------------------------------------##
##------------------------------------------------------------##
##------------------------------------------------------------##
##------------------------------------------------------------##
##------------------------------------------------------------##
##------------------------------------------------------------##
##-----######---#----#---######---#####----#####--------------##
##-----#--------#----#---#----#---#----#---#------------------##
##-----#--------#----#---#----#---#----#---#------------------##
##-----#--------#----#---#----#---#----#---#------------------##
##-----######---######---######---#----#---#####--------------##
##----------#---#----#---#----#---#----#---#------------------##
##----------#---#----#---#----#---#----#---#------------------##
##----------#---#----#---#----#---#----#---#------------------##
##----------#---#----#---#----#---#----#---#------------------##
##-----######---#----#---#----#---#####----#GGGG--------------##
##------------------------------------------------------------##
##------------------------------------------------------------##
##---------------#####---#---#---#####---#####---####---####--##
##---------------#-------#---#---#---#---#---#---#------#--#--##
##---------------#-------#---#---#---#---#---#---#------#--#--##
##---------------#-------#---#---#---#---#---#---#------#--#--##
##---------------#####---#####---#####---#####---####---#####-##
##-------------------#---#---#---#---#---#-------#------#---#-##
##-------------------#---#---#---#---#---#-------#------#---#-##
##-------------------#---#---#---#---#---#-------#------#---#-##
##---------------GGGG#---#---#---#---#---#-------####---#---#-##
##------------------------------------------------------------##
##------------------------------------------------------------##
##------------------------------------------------------------##
#######P##################################################GGGG##
################################################################
